! Kilobolt Studios
! http://kilobolt.com
! Game Development Tutorial - Unit 3
! Q-Bot Level 1
! # = Tile Legend 
! 5 = TileDirt
! 8 = GrassTop
! 2 = GrassBottom
! 4 = GrassLeft
! 6 = GrassRight 
22222222222222222222222222222222222225555555555555555552222222222222222222222222222222222222222222222222222222222222222222222222222222222222222222222222222222222222222222222222222222222222222222222222222222222222222222222222222222222222222222222222222222222222222222222222222222222222222222222222222
                                     555555555555555555
                                     222222222222222222
                                     
                                     
                                     
                                        888888888888                                                                                                                                                                                                                                                                 8
                                     88855555555555588                                                                                                                                                                                                                                                               5
                                     55555555555555555888                                                                                                                                                                                                                                                            5
                                   8855555555555555555555                                                                                                                                                                                                                                                            5
                                   5555555555555555555555                                                                                                                                                                                                                                                            5
888888888888888888888888    88888885555555555555555555555888888888888888888   88    88  88   88   88   888   88   8888888888888888888888888888888888888888888888888888888888888888888888888888888888888888888888888888888888888888888888888888888888888888888888888888888888888888888888888888888888888888888888888885
#         #         #         #         #         #         #         #         #         #         #         #         #         #         #         #         #         #         #         #         #         #         #         #         #         #         #         #         #         #         #         